Account_No,DATE,TRANSACTION_DETAILS,CHQ_NO,VALUE_DATE,WITHDRAWAL_AMT,DEPOSIT_AMT,BALANCE_AMT
123456789,29-Jun-17,TRF FROM  Indiaforensic SERVICES,,29-Jun-17,,"10,00,000.00","10,00,000.00"
123456789,05-Jul-17,TRF FROM  Indiaforensic SERVICES,,05-Jul-17,,"10,00,000.00","20,00,000.00"
123456789,18-Jul-17,FDRL/INTERNAL FUND TRANSFE,,18-Jul-17,,"5,00,000.00","25,00,000.00"
123456789,01-Aug-17,TRF FRM  Indiaforensic SERVICES,,01-Aug-17,,"30,00,000.00","55,00,000.00"
123456789,16-Aug-17,FDRL/INTERNAL FUND TRANSFE,,16-Aug-17,,"5,00,000.00","60,00,000.00"
123456789,17-Aug-17,TRF TO DELTIN ROYALE,,17-Aug-17,,"5,00,000.00","65,00,000.00"
123456789,18-Aug-17,TRF TO BAJ FINANCE,,18-Aug-17,"5,00,000.00",,"60,00,000.00"
123456789,19-Aug-17,FDRL/INTERNAL FUND TRANSFE,,19-Aug-17,"5,00,000.00",,"55,00,000.00"
